                                                                                
                                                                                
                                                                                
                                                                                
                                                                                
                                                                                
                                                                                
                                                                                
                                                                                
                                                                                
                                                                                
                               #################################################
                               #                                               #
                               #   A     d    d          d       d             #
                               #                                               #
                               #         d    d          d        d            #
                               #                                               #
                               #               >   <                     >* <  #
                               ###############################.#################
                               ###############################.#################
                               ###############################.####.......## . #
                               ##        #       #   #    #   .###....>#####..##
                               ##   d  d   ### ### # #  # ######## <..........##
                               ##            #     #    #     ...........###..##
                               #############################################..##