                                                                                
                                                                                
                                                                                
                                                                                
                                                                                
                                                                                
                                                                                
                                                                                
                                                                                
                                                                                
                                                                                
                               #################################################
                               #                                               #
                               #   A     d                                     #
                               #                                               #
                               #         d                                     #
                               #                                      d        #
                               #               >   <                     >* <  #
                               ###############################.#################
                               ###############################.#################
                               ###############################.####.......## . #
                               ##        #       #   #    #   .###....>#####..##
                               ##          ### ### # #  # ######## <..........##
                               ##            #     #    #     ...........###..##
                               #############################################..##