                                                                                
                                                                                
                                                                                
                                                                                
                                                                                
                                                                                
                                                                                
                                                                                
                                                                                
                                                                                
                                                                                
                               #################################################
                               #                                               #
                               #                                               #
                               #                                               #
                               #                                               #
                               #                                               #
                               #               **                        *     #
                               #################. #######..###############.#####
                               ############.<.... .........###############.#####
                               ##########################..###############.#####
                               ##                       # .#########   .......##
                               ##                       # ........  .  #########
                               ##                #####################...###..##
                               #############################################..##