                                                                                
                                                                                
                                                                                
                                                                                
                                                                                
                                                                                
                                                                                
                                                                                
                                                                                
                                                                                
                                                                                
                               #################################################
                               ## ########### ##################################
                               ## ########### ##################################
                               ## #########   ##  ##############################
                               ## ### ## # ## # ## #############################
                               ## ### ## # ## # ## #############################
                               ##   ##  ###  ###  ##############################
                               #################################################
                               #########<     ##################################
                               #################################################
                               ##             ##################################
                               ##             ##################################
                               ##             ##################################
                               #################################################